1111111111111111111111111111111111
1E1000000000001C10000C000000000001
1010011100100000101111000000010101
1010010000100000001111000000X10101
1P0000000X000001100000000C00000001
1000000000000001100000000000000001
1000C0000000X000000000111000000001
100000000110C000000000111000000001
1000000001100000000000000000110001
100000000X000000000000000000110001
100011000C000000000011100000000001
1111111111111111111111111111111111