111111111111111111111111111111111111111111111111111111111111111111111111111111111111111111111111111111111111111111111111111111111111111111111111111111111111111111111111111111111111111111111111111111111111111111111111111111
111000010110100101010100101100111010101011010001011000001111010101011100011001110100001101010010111100000111110101111001100110001100110000000001011110100110100000111101111000101100000000100101011010111010100001111111111111
101100010001000000010111111110100110100001001110011111100000111011101100010110100101100010111011110000111010111110101101011111010111000101010011011011100101110100011101101100101010001001001010111110000111010001001011100111
100000011011101001010011000101001111001111111011101010001011000011100011001111101111100000110010001011011100111110011110100000100101101001101011001101001000100111011111000000001100101100100001111110000000100101111011101011
1011C1111100110110110100000000011100011110011000000110001111100100000000101000010111011010011110101101001100101111010000100000100010011111010000100110011110111101011011101010111010000001010111100010100101000000110101101111
1P1000000100100110000100001111100000110101101111100000100001010010101110110101111000011110111001111000000000000100000000000000000000000000000000000000000000000000000000000000001101010101010101010101010101001010101001011111
100000000000000000000000000000000000000000000000000000000000011111111111111111111111111111111111111111111111111111111111111111111111111111111111111111111111111111111111111111111111111111111111111111111111111111111111111111
111000010110100101010100100000000000000000000000000000000111010101011100011001110100001101010010111100000111110101111001100110001100110000000001011110100110100000111101111000101100000000100101011010111010100001111111111111
101100010001000000010111111110100110100001001110011111100000111011101100010110100101100010111011110000111010111110101101011111010111000101010011011011100101110100011101101100101010001001001010111110000111010001001011100111
100010011011101001010011000101001100001000000000000000000000000001100011001111101111100000110010001011011100111110011110100000100101101001101011001101001000100111011111000000001100101100100001111110000000100101111011101011
101101111100110110110100000000011100011110011000000110001111100100000000101000010111011010011110101101001100101111010000100000100010011111010000100110011110111101011011101010111010000001010111100010100101000000110101101111
101000000100100110000100001111100000110101101111100000100001010010101110110101111000011110111001111000000000000100000000000000000000000000000000000000000000000000000000000000001101010101010101010101010101001010101001011111
111111111111111111111111111111111111111111111111100000100001011111111111111111111111111111111111111111111111111111111111111111111111111111111111111111111111111111111111111111111111111111111111111111111111111111111111111111
111111111111111111111111111111111111111111111111111001111111111111111111111111111111111111111111111111111111111111111111111111111111111111111111111111111111111111111111111111111111111111111111111111111111111111111111111111
111000010110100101010100101100111010101011010001011000C01111010101011100011001110100001101010010111100000111110101111001100110001100110000000001011110100110100000111101111000101100000000100101011010111010100001111111111111
101100010001000000010111111110100110100001001110011111100000111011101100010110100101100010111011110000111010111110101101011111010111000101010011011011100101110100011101101100101010001001001010111110000111010001001011100111
100010011011101001010011000101001111001111111011101010001011000011100011001111101111100000110010001011011100111110011110100000100101101001101011001101001000100111011111000000001100101100100001111110000000100101111011101011
101101111100110110110100000000011100011110011000000110001111100100000000101000010111011010011110101101001100101111010000100000100010011111010000100110011110111101011011101010111010000001010111100010100101000000110101101111
101000000100100110000100001111100000110101101111100000100001010010101110110101111000011110111001111000000000000100000000000000000000000000000000000000000000000000000000000000001101010101010101010101010101001010101001011111
111111111111111111111111111111111111111111111111111111100111111111111111111111111111111111111111111111111111111111111111111111111111111111111111111111111111111111111111111111111111111111111111111111111111111111111111111111
111111111111111111111111111111111111111111111111111111100111111111111111111111111111111111111111111111111111111111111111111111111111111111111111111111111111111111111111111111111111111111111111111111111111111111111111111111
111000010110100101010100101100111010101011010001011000001111010101011100011001110100001101010010111100000111110101111001100110001100110000000001011110100110100000111101111000101100000000100101011010111010100001111111111111
101100010001000000010111111110100110100001001110011111100000111011101100010110100101100010111011110000111010111110101101011111010111000101010011011011100101110100011101101100101010001001001010111110000111010001001011100111
100010011011101001010011000101001111001111111011101010001011000011100011001111101111100000110010001011011100111110011110100000100101101001101011001101001000100111011111000000001100101100100001111110000000100101111011101011
101101111100110110110100000000011100011110011000000110001111100100000000101000010111011010011110101101001100101111010000100000100010011111010000100110011110111101011011101010111010000001010111100010100101000000110101101111
101000000100100110000100001111100000110101101111100000100001010010101110110101111000011110111001111000000000000100000000000000000000000000000000000000000000000000000000000000001101010101010101010101010101001010101001011111
11111111111111111111111111111111111111111111111111111110C111111111111111111111111111111111111111111111111111111111111111111111111111111111111111111111111111111111111111111111111111111111111111111111111111111111111111111111
111111111111111111111111111111111111111111111111111111100111111111111111111111111111111111111111111111111111111111111111111111111111111111111111111111111111111111111111111111111111111111111111111111111111111111111111111111
111000010110100101010100101100111010101011010001011000000111010101011100011001110100001101010010111100000111110101111001100110001100110000000001011110100110100000111101111000101100000000100101011010111010100001111111111111
101100010001000000010111111110100110100001001110011111100000111011101100010110100101100010111011110000111010111110101101011111010111000101010011011011100101110100011101101100101010001001001010111110000111010001001011100111
100010011011101001010011000101001111001111111011101010001011000011100011001111101111100000110010001011011100111110011110100000100101101001101011001101001000100111011111000000001100101100100001111110000000100101111011101011
101101111100110110110100000000011100011110011000000110001111100100000000101000010111011010011110101101001100101111010000100000100010011111010000100110011110111101011011101010111010000001010111100010100101000000110101101111
101000000100100110000100001111100000110101101111100000100001010010101110110101111000011110111001111000000000000100000000000000000000000000000000000000000000000000000000000000001101010101010101010101010101001010101001011111
1111111111111111111111111111111111111111111111111111000000000000000000000000C00000000000000000000000C000000C00000C000000000000000000000000000000000000000000000000000011111111111111111111111111111111111111111111111111111111
111111111111111111111111111111111111111111111111111111111111111111111111111111111111111111111111111111111111111111111111111111111111111111111111111111111111110000111111111111111111111111111111111111111111111111111111111111
111000010110100101010100101100111010101011010001011000001111010101011100011001110100001101010010111100000111110101111001100110001100110000000001011110100110100000111101111000101100000000100101011010111010100001111111111111
101100010001000000010111111110100110100001001110011111100000111011101100010110100101100010111011110000111010111110101101011111010111000101010011011011100101110100011101101100101010001001001010111110000111010001001011100111
100010011011101001010011000101001111001111111011101010001011000011100011001111101111100000110010001011011100111110011110100000100101101001101011001101001000100111011111000000001100101100100001111110000000100101111011101011
101101111100110110110100000000011100011110011000000110001111100100000000101000010111011010011110101101001100101111010000100000100010011111010000100110011110111101011011101010111010000001010111100010100101000000110101101111
101000000100100110000100001111100000110101101111100000100001010010101110110101111000011110111001111000000000000000000000000000000000000000000000000000000000000000000000000000001101010101010101010101010101001010101001011111
111111111111111111111111111111111111111111111111111111111111111111111111111111111111111111111111111110011111111111111111111111111111111111111111111111111111111111111111111111111111111111111111111111111111111111111111111111
111111111111111111111111111111111111111111111111111111111111111111111111111111111111111111111111111110011111111111111111111111111111111111111111111111111111111111111111111111111111111111111111111111111111111111111111111111
111000010110100101010100101100111010101011010001011000001111010101011100011001110100001101010010111100000111110101111001100110001100110000000001011110100110100000111101111000101100000000100101011010111010100001111111111111
101100010001000000010111111110100110100001001110011111100000111011101100010110100101100010111011110000111010111110101101011111010111000101010011011011100101110100011101101100101010001001001010111110000111010001001011100111
100010011011101001010011000101001111001111111011101010001011000011100011001111101111100000110010001010011100111110011110100000100101101001101011001101001000100111011111000000001100101100100001111110000000100101111011101011
101101111100110110110100000000011100011110011000000110001111100100000000101000010111011010011110101100001100101111010000100000100010011111010000100110011110111101011011101010111010000001010111100010100101000000110101101111
10100000010010011000010000111110000011010110111110000010000101001010111011010111100001111011100111100C0000000000000000000000000000000000000000000000000000000000000000000000000E1101010101010101010101010101001010101001011111
111111111111111111111111111111111111111111111111111111111111111111111111111111111111111111111111111111111111111111111111111111111111111111111111111111111111111111111111111111111111111111111111111111111111111111111111111111
111111111111111111111111111111111111111111111111111111111111111111111111111111111111111111111111111111111111111111111111111111111111111111111111111111111111111111111111111111111111111111111111111111111111111111111111111111